--..!..##...??..+.-
.....--......???..#
!!...++...---..+.--
...............)+#-
...!.#....--..#..-.
........++....-#.-+
<@......!!.....##.+
.....!...........#+
.....#...--....?.+-
...?....#+.......-.
~~~~~~~~~~~~~~~~~~~~